20211222 0
20211223 0
20211224 0
20211225 0
20211226 0
20211227 0
20211228 0
20211229 0
20211230 0
20211231 0
20220101 0
20220102 0
20220103 0
20220104 0
20220105 0
20220106 0
20220107 0
20220108 0
20220109 0
20220110 0
20220111 0
20220112 0
20220113 0
20220114 0
20220115 0
20220116 0
20220117 0
20220118 0
20220119 0
20220120 0
20220121 0
20220122 0
20220123 0
20220124 0
20220125 0
20220126 0
20220127 0
20220128 0
20220129 0
20220130 0
20220131 0
20220201 0
20220202 0
20220203 0
20220204 0
20220205 0
20220206 0
20220207 0
20220208 0
20220209 0
20220210 0
20220211 0
20220212 0
20220213 0
20220214 0
20220215 0
20220216 0
20220217 0
20220218 0
20220219 0
20220220 0
20220221 0
20220222 0
20220223 0
20220224 0
20220225 0
20220226 0
20220227 0
20220228 0
20220301 0
20220302 0
20220303 0
20220304 0
20220305 0
20220306 0
20220307 0
20220308 0
20220309 0
20220310 0
20220311 0
20220312 0
20220313 0
20220314 0
20220315 0
20220316 0
20220317 0
20220318 0
20220319 0
20220320 0
20220321 0
20220322 0
20220323 0
20220324 0
20220325 0
20220326 0
20220327 0
20220328 0
20220329 0
20220330 0
20220331 0
20220401 0
20220402 0
20220403 0
20220404 0
20220405 0
20220406 0
20220407 0
20220408 0
20220409 0
20220410 0
20220411 0
20220412 0
20220413 0
20220414 0
20220415 0
20220416 0
20220417 0
20220418 0
20220419 0
20220420 0
20220421 0
20220422 0
20220423 0
20220424 0
20220425 0
20220426 0
20220427 0
20220428 0
20220429 0
20220430 0
20220501 0
20220502 0
20220503 0
20220504 0
20220505 0
20220506 0
20220507 0
20220508 0
20220509 0
20220510 0
20220511 0
20220512 0
20220513 0
20220514 0
20220515 0
20220516 0
20220517 0
20220518 1 04:57 05:23
20220519 0
20220520 0
20220521 0
20220522 0
20220523 0
20220524 0
20220525 0
20220526 0
20220527 0
20220528 0
20220529 0
20220530 0
20220531 0
20220601 0
20220602 0
20220603 0
20220604 0
20220605 0
20220606 0
20220607 0
20220608 0
20220609 0
20220610 0
20220611 0
20220612 0
20220613 0
20220614 0
20220615 0
20220616 1 04:37 05:28
20220617 1 05:49 05:56
20220618 0
20220619 0
20220620 0
20220621 0
20220622 0
20220623 0
20220624 0
20220625 0
20220626 0
20220627 0
20220628 0
20220629 0
20220630 0
20220701 0
20220702 0
20220703 0
20220704 0
20220705 0
20220706 0
20220707 0
20220708 0
20220709 0
20220710 0
20220711 0
20220712 0
20220713 0
20220714 0
20220715 1 04:26 05:28
20220716 1 05:13 06:16
20220717 0
20220718 0
20220719 0
20220720 0
20220721 0
20220722 0
20220723 0
20220724 0
20220725 0
20220726 0
20220727 0
20220728 0
20220729 0
20220730 0
20220731 0
20220801 0
20220802 0
20220803 0
20220804 0
20220805 0
20220806 0
20220807 0
20220808 0
20220809 0
20220810 0
20220811 0
20220812 0
20220813 1 04:14 05:18
20220814 1 04:53 06:01
20220815 0
20220816 0
20220817 0
20220818 0
20220819 0
20220820 0
20220821 0
20220822 0
20220823 0
20220824 0
20220825 0
20220826 0
20220827 0
20220828 0
20220829 0
20220830 0
20220831 0
20220901 0
20220902 0
20220903 0
20220904 0
20220905 0
20220906 0
20220907 0
20220908 0
20220909 0
20220910 0
20220911 0
20220912 0
20220913 0
20220914 0
20220915 0
20220916 0
20220917 0
20220918 0
20220919 0
20220920 0
20220921 0
20220922 0
20220923 0
20220924 0
20220925 0
20220926 0
20220927 0
20220928 0
20220929 0
20220930 0
20221001 0
20221002 0
20221003 0
20221004 0
20221005 0
20221006 0
20221007 0
20221008 0
20221009 0
20221010 0
20221011 0
20221012 0
20221013 0
20221014 0
20221015 0
20221016 0
20221017 0
20221018 0
20221019 0
20221020 0
20221021 0
20221022 0
20221023 0
20221024 0
20221025 0
20221026 0
20221027 0
20221028 0
20221029 0
20221030 0
20221031 0
20221101 0
20221102 0
20221103 0
20221104 0
20221105 0
20221106 0
20221107 0
20221108 0
20221109 0
20221110 0
20221111 0
20221112 0
20221113 0
20221114 0
20221115 0
20221116 0
20221117 0
20221118 0
20221119 0
20221120 0
20221121 0
20221122 0
20221123 0
20221124 0
20221125 0
20221126 0
20221127 0
20221128 0
20221129 0
20221130 0
20221201 0
20221202 0
20221203 0
20221204 0
20221205 0
20221206 0
20221207 0
20221208 0
20221209 0
20221210 0
20221211 0
20221212 0
20221213 0
20221214 0
20221215 0
20221216 0
20221217 0
20221218 0
20221219 0
20221220 0
20221221 0
20221222 0
20221223 0
20221224 0
20221225 0
20221226 0
20221227 0
20221228 0
20221229 0
20221230 0
20221231 0
